*****************
*      *        *
*  ?    *       *
*  ?    ****    *
*  ?            *
*******         *
*        **     *
*         ****  *
*  ??       *   *
*****************