*****************
*      *        *
*      *        *
*      ****     *
*               *
*******         *
*        **     *
*         ****  *
*         *     *
*****************